**..........**..........**
**..........**..........**
..==..==..==..==..==..==..
..==..==..==..==..==..==..
..==..==..==..==..==..==..
..==..==..==..==..==..==..
..==..==..==##==..==..==..
..==..==..==##==..==..==..
..==..==..==..==..==..==..
..==..==..........==..==..
..==..==..........==..==..
..........==..==..........
..........==..==..........
==..====..........====..==
##..====..........====..##
..........==..==..........
..........======..........
..==..==..======..==..==..
..==..==..==..==..==..==..
..==..==..==..==..==..==..
..==..==..==..==..==..==..
..==..==..........==..==..
..==..==..........==..==..
..==..==...====...==..==..
...........=**=...........
...........=**=...........
